2222222222222222222222
2000000000021112000002
2000000000021112000002
2000000000021112000002
2000000000021112000002
2000000000021112000002
2000000040021112030002
2000000000022222000002
2000000000000000000002
2000000000022222000002
2000000000021112000002
2222222222221112222222
2111111111111111111112
2111111111111111111112
2111111111111111111112
2222222111111111111112
2000002111111111111112
2000002111111111111112
2000002111111111111112
2000002111111111111112
2000002111111111111112
2222222111111111111112
2111111111111111111112
2111111111111111111112
2111111111111111111112
2111111111111111111112
2222222222222222222222
